12
30
##############################
#H ###########################
#  #                      ####
#  #  ##################  ####
#  #  #P               #  ####
#  #  ###############  #  ####
#  #                   #  ####
#  #####################  ####
#                         ####
#  ########################  #
#                       U   F#
##############################
