9
18
##################
#H         U     #
#########  ##    #
#    O A   ####O #
#  #########  #  #
#  # 2        #  #
#  ###### O##O#  #
#                #
##################
