11
25
########################
#H             # #  3  #
#           #    #  #  #
#############  # #  #  #
#              #S#  #  #
#O ############# #  #  #
#  #      U U U U#  #  #
# U#  ############  #  #
#  #                #  #
#O       #OO#          #
########################